       
 #D#####
 #     #
 #     #
 #     #
 #BBBBB#